from	from	from
:	:	:
tffreeba@indyvax.iupui.edu	tffreeba@indyvax.iupui.edu	tffreeba@indyvax.iupui.edu

subject	subject	subject
:	:	:
re	re	re
:	:	:
planets	planet	planet
still	still	still
:	:	:
images	imag	image
orbit	orbit	orbit
by	by	by
ether	ether	ether
twist	twist	twist

lines	line	line
:	:	:
3	3	3

they	they	they
must	must	must
be	be	be
shipping	ship	shipping
that	that	that
good	good	good
eau	eau	eau
clair	clair	clair
acid	acid	acid
to	to	to
california	california	california
now	now	now
.	.	.

tom	tom	tom
freebairn	freebairn	freebairn