from	from	from
:	:	:
passman@world.std.com	passman@world.std.com	passman@world.std.com
(	(	(
shirley	shirley	shirley
l	l	l
passman	passman	passman
)	)	)

subject	subject	subject
:	:	:
help	help	help
with	with	with
no	no	no
docs	doc	doc
for	for	for
motherboard	motherboard	motherboard

organization	organ	organization
:	:	:
the	the	the
world	world	world
public	public	public
access	access	access
unix	unix	unix
,	,	,
brookline	brooklin	brookline
,	,	,
ma	ma	ma

lines	line	line
:	:	:
1	1	1